    [G] [R]                 [P]    
    [H] [W]     [T] [P]     [H]    
    [F] [T] [P] [B] [D]     [N]    
[L] [T] [M] [Q] [L] [C]     [Z]    
[C] [C] [N] [V] [S] [H]     [V] [G]
[G] [L] [F] [D] [M] [V] [T] [J] [H]
[M] [D] [J] [F] [F] [N] [C] [S] [F]
[Q] [R] [V] [J] [N] [R] [H] [G] [Z]
